Toy Story 3|Animation; Adventure; Comedy; Family; Fantasy
Interstellar|Adventure; Sci-Fi
The Avengers|Action; Adventure; Sci-Fi
How to Train Your Dragon|Animation; Adventure; Family; Fantasy
The Wolf of Wall Street|Biography; Comedy; Crime; Drama
Boyhood|Drama
Shutter Island|Mystery; Thriller
Harry Potter and the Deathly Hallows: Part 2|Adventure; Fantasy; Mystery
Incendies|Drama; Mystery; War
Warrior|Drama; Sport
The Dark Knight Rises|Action; Thriller
Inception|Action; Mystery; Sci-Fi; Thriller
Prisoners|Crime; Drama; Mystery; Thriller
The Help|Drama
The King's Speech|Biography; Drama; History
Elite Squad: The Enemy Within|Action; Crime; Drama; Thriller
The Intouchables|Biography; Comedy; Drama
Jodaeiye Nader az Simin|Drama
Django Unchained|Western
X-Men: Days of Future Past|Action; Adventure; Sci-Fi; Thriller
Gangs of Wasseypur|Action; Crime; Drama; Thriller
Rush|Action; Biography; Drama; Sport
Guardians of the Galaxy|Action; Adventure; Sci-Fi
12 Years a Slave|Biography; Drama; History
The Imitation Game|Biography; Drama; Thriller; War
Jagten|Drama
Gone Girl|Drama; Mystery; Thriller
The Grand Budapest Hotel|Adventure; Comedy; Drama
Whiplash|Drama; Music
Kingsman: The Secret Service|Action; Adventure; Comedy; Crime
